###############
#.............#
#.............#
#.............#
#.............#
#....######...#
#.............#
#.............#
#.............#
#.............#
#....#####....#
#....#........#
#....#####....#
#.............#
#.............#
###############
